blue
pyramid
180
11
10
2 2 2 2 2 0 0 0 0 0 0
2 1 1 1 2 0 0 0 0 0 0
2 1 1 1 3 2 2 2 2 2 0
2 1 1 3 1 1 1 1 1 2 0
2 1 3 1 1 1 1 1 1 3 2
2 1 3 1 1 3 1 3 3 1 2
2 1 1 1 1 3 1 3 1 1 2
2 3 3 1 3 1 1 3 1 1 2
0 2 1 1 1 1 1 1 1 1 2
0 2 2 2 2 2 2 2 2 2 2
3
0 8 3 2
1 10 8 6
0 2 3 7
WATER
3
1
0 2 1 10 0 8
