blue
blue
150
13
13
0 0 0 0 0 0 0 0 0 3 3 3 3
3 3 3 3 3 3 0 3 3 3 1 1 3
3 1 1 1 1 3 0 3 1 1 1 1 3
3 1 1 1 1 3 3 3 1 1 4 1 3
3 1 4 4 1 1 1 1 1 1 1 1 3
3 1 1 1 1 1 1 1 1 4 4 4 4
4 4 4 4 1 1 4 4 1 1 1 1 3
3 1 1 1 1 1 1 1 1 1 4 1 3
4 4 1 1 4 1 4 1 1 4 1 4 4
3 1 1 1 4 1 1 1 1 1 1 1 3
4 4 1 1 1 1 1 1 4 1 4 1 3
3 1 1 1 1 1 4 1 4 1 1 1 3
3 3 3 3 3 3 4 3 4 3 3 3 3
5
2 266 4 6
0 2 5 6
1 1024 6 7
1 10 10 8
0 8 6 10
METHAN SOURNESS
4
2
0 0 1 1024 0 0 0 0
0 2 2 266 1 10 0 8
