blue
square
210
10
11
0 2 2 2 2 2 2 2 0 0
0 2 1 1 1 1 1 3 2 2
0 2 1 1 3 1 1 1 1 2
2 3 1 3 1 1 3 3 3 3
2 1 1 3 1 1 1 1 1 2
2 1 1 1 3 3 1 1 1 2
2 1 1 1 1 1 3 1 1 2
2 1 1 3 1 1 1 1 1 2
2 3 1 1 1 3 1 3 1 2
0 2 2 2 2 3 1 1 1 2
0 0 0 0 0 2 2 2 2 2
8
0 4 4 1
0 8 3 2
1 1024 6 2
2 15 3 5
0 2 6 5
2 266 7 6
0 1 2 7
1 10 6 8
ETHAN SOURNESS
5
3
0 0 0 4 1 1024 0 0 0 0
0 2 2 15 2 266 1 10 0 8
0 0 0 1 0 0 0 0 0 0
