blue
pyr_square
300
14
12
3 3 3 3 3 3 3 3 3 3 3 3 3 3
3 1 1 1 1 1 2 1 1 1 1 1 1 3
3 1 1 2 2 1 2 1 1 2 2 1 1 3
3 1 1 1 1 1 2 1 1 1 1 1 1 3
3 1 2 1 2 2 2 1 2 2 2 1 1 3
3 1 2 1 1 1 2 1 2 1 1 1 1 3
3 1 1 1 1 1 2 1 1 1 1 2 1 3
3 1 1 1 1 1 1 1 1 1 1 1 1 3
3 1 2 2 2 1 2 2 1 2 2 2 1 3
3 1 1 1 1 1 1 1 1 1 1 1 1 3
3 1 1 1 1 1 1 1 2 1 1 1 1 3
3 3 3 3 3 3 3 3 3 3 3 3 3 3
12
0 64 9 1
0 64 5 2
0 16 3 3
2 240 7 3
0 16 9 3
0 128 12 3
2 240 3 5
2 2144 11 5
0 32 1 6
2 656 2 9
0 16 9 10
0 64 11 10
TRANSBUTEN
6
5
0 0 0 0 0 0 0 64 0 0 0 128
0 0 0 64 0 0 0 0 2 240 0 0
0 64 0 0 2 656 2 2144 0 0 0 16
0 0 2 240 0 0 0 0 0 16 0 0
0 32 0 0 0 16 0 0 0 0 0 0
