blue
blue
300
13
12
2 4 4 4 4 4 4 4 4 4 4 4 2
4 1 1 1 1 1 1 1 1 1 1 1 4
4 1 1 1 1 1 2 1 1 1 1 1 4
2 2 1 2 1 1 2 1 2 2 1 1 4
4 1 1 2 1 1 1 1 1 1 1 1 4
4 1 2 2 1 2 2 2 2 2 1 1 4
4 1 1 2 1 1 1 1 1 1 1 1 4
4 1 1 1 1 1 1 2 1 1 1 1 4
4 1 2 2 1 2 1 1 1 1 2 1 4
4 1 1 1 1 1 1 1 1 1 1 1 4
4 1 1 1 1 1 1 2 1 1 1 1 4
4 4 4 4 4 4 4 2 4 4 4 4 4
12
0 32 10 1
0 32 3 2
0 64 5 2
2 656 7 3
0 64 10 3
2 2144 2 4
0 16 8 4
0 16 11 5
0 128 1 6
0 128 11 7
2 240 10 9
2 240 1 10
CISBUTEN
6
4
0 0 0 64 0 0 0 0 0 128 0 0
0 64 0 0 2 656 2 2144 0 0 0 128
0 0 2 240 0 0 0 0 2 240 0 0
0 32 0 0 0 16 0 32 0 0 0 16
