blue
square
150
14
11
2 2 2 2 2 0 0 0 0 0 0 0 0 0
2 1 1 1 2 0 0 0 0 0 0 0 0 0
2 1 1 1 3 2 3 2 2 2 2 2 2 2
2 1 3 1 3 1 3 1 1 1 1 1 1 2
2 1 3 1 3 1 3 1 1 1 3 1 1 2
2 1 1 3 1 1 3 3 3 3 3 1 1 2
2 1 1 1 1 1 1 1 3 1 1 1 1 2
2 1 1 1 1 1 1 1 3 1 1 1 1 2
2 1 3 3 3 3 3 1 1 1 1 1 1 2
2 1 1 1 3 1 1 2 2 2 2 2 2 2
2 2 2 2 2 2 2 2 0 0 0 0 0 0
5
0 2 2 5
2 15 5 4
0 8 8 8
0 4 9 4
0 1 3 9
METHAN
3
3
0 0 0 4 0 0
0 2 2 15 0 8
0 0 0 1 0 0
