blue
ice
240
13
13
2 2 2 2 0 0 0 0 0 0 0 0 0
2 1 1 2 0 0 0 0 0 0 0 0 0
2 1 1 2 0 0 0 0 0 0 0 0 0
2 1 1 2 0 0 0 0 0 0 0 0 0
2 1 1 2 2 2 2 2 2 2 2 0 0
2 1 1 1 3 1 1 1 3 1 2 2 2
2 1 3 1 1 1 1 1 3 1 1 1 2
2 1 1 1 1 1 1 1 3 1 1 1 2
2 1 1 3 3 3 1 1 3 1 3 1 2
2 1 1 1 1 1 1 1 1 1 1 1 2
2 1 1 1 1 1 1 3 1 1 3 1 2
2 2 2 2 2 2 1 1 1 1 3 1 2
0 0 0 0 0 2 2 2 2 2 2 2 2
6
0 4 2 3
0 2 2 8
1 10 6 8
2 15 9 7
0 1 5 10
0 8 8 10
METHANOL
4
3
0 0 0 4 0 0 0 0
0 2 2 15 1 10 0 8
0 0 0 1 0 0 0 0
