blue
pyr_square
210
11
13
2 2 3 2 2 2 2 0 0 0 0
2 1 3 1 1 1 2 0 0 0 0
2 1 3 1 4 1 2 0 0 0 0
2 1 3 1 1 1 2 0 0 0 0
2 1 3 1 1 1 2 0 0 0 0
2 1 1 1 3 3 3 2 2 2 2
2 1 1 1 1 1 1 1 1 1 2
2 1 1 3 3 1 1 1 1 1 2
2 1 1 1 1 1 1 3 3 3 3
3 3 1 1 3 1 1 1 1 1 2
2 1 1 1 3 1 3 1 1 1 2
2 1 1 1 3 1 1 1 2 2 2
2 2 2 2 3 2 2 2 2 0 0
6
0 32 3 2
2 2144 2 7
2 656 5 7
0 128 7 7
0 64 5 9
0 16 3 11
ETHEN
4
3
0 64 0 0 0 0 0 128
0 0 2 656 2 2144 0 0
0 32 0 0 0 0 0 16
