blue
blue2
240
14
13
0 0 0 0 0 0 2 2 2 2 0 0 0 0
0 0 2 2 2 2 2 1 1 2 0 0 0 0
0 0 2 1 1 1 1 1 1 2 0 0 0 0
0 0 2 1 1 1 2 2 2 2 2 2 2 2
0 0 2 1 1 1 1 1 1 2 1 1 1 2
0 0 3 3 3 3 1 1 2 2 1 1 1 2
2 2 2 1 1 3 1 1 1 2 1 1 1 2
2 1 1 1 1 3 1 1 1 1 1 1 1 2
2 1 3 1 1 3 1 3 3 3 3 3 3 3
2 1 1 1 1 1 1 1 1 1 1 1 1 2
2 1 1 1 3 1 1 1 1 3 3 1 1 2
2 1 1 1 3 1 1 1 1 1 1 1 1 2
2 2 2 2 3 2 2 2 2 2 2 2 2 2
9
0 128 8 2
0 4 5 3
2 521 3 4
2 2144 11 5
0 2 3 6
2 15 8 6
0 4 10 7
0 16 1 11
0 1 9 11
PROPEN
5
3
0 0 0 4 0 4 0 0 0 128
0 2 2 15 2 521 2 2144 0 0
0 0 0 1 0 0 0 0 0 16
