blue
blue
150
13
13
2 2 2 2 2 2 2 2 2 2 2 0 0
2 1 1 1 1 1 1 1 1 1 2 0 0
2 1 3 3 1 1 3 1 1 1 2 0 0
2 1 1 1 1 1 1 3 1 1 2 0 0
2 1 1 1 3 1 1 3 1 1 2 0 0
2 1 3 1 3 1 1 3 1 1 2 0 0
2 1 1 1 1 1 1 1 1 3 2 2 2
2 2 3 3 3 1 1 3 1 1 1 1 2
0 2 1 1 1 1 1 3 1 3 1 1 2
2 2 1 3 3 1 1 1 1 1 1 1 2
2 1 1 1 1 1 1 1 2 2 2 2 2
2 1 1 1 1 1 3 1 2 0 0 0 0
2 2 2 2 2 2 2 2 2 0 0 0 0
9
0 4 3 1
2 15 6 3
0 8 3 5
2 15 8 5
1 10 5 8
0 2 2 9
0 4 9 9
0 1 6 10
0 1 4 11
ETHANOL
5
3
0 0 0 4 0 4 0 0 0 0
0 2 2 15 2 15 1 10 0 8
0 0 0 1 0 1 0 0 0 0
