blue
arrow
150
12
13
3 2 2 2 2 2 3 2 2 2 2 0
4 1 1 1 1 1 4 1 1 1 4 0
4 1 1 1 1 1 4 1 1 1 4 0
4 1 1 4 1 1 1 1 1 1 4 0
4 1 1 4 1 3 2 2 3 1 3 3
4 1 1 4 1 4 1 1 4 1 1 4
4 1 2 3 1 1 1 1 4 1 1 4
4 1 1 1 1 1 1 1 4 1 1 4
4 1 1 4 1 1 1 2 3 1 1 4
4 1 1 5 3 1 1 1 1 1 1 4
4 1 1 1 4 1 1 1 1 2 2 3
4 1 1 1 4 1 1 4 1 1 1 4
3 2 2 2 3 2 2 3 2 2 2 3
12
0 4 8 1
1 5 6 3
0 4 2 4
0 1 4 4
0 1 7 5
2 15 9 5
0 4 9 7
2 15 2 8
0 1 7 9
0 8 9 9
0 2 3 10
2 15 7 10
PROPANOL
5
4
0 0 0 4 0 4 0 4 0 0
0 2 2 15 2 15 2 15 0 8
0 0 0 1 1 5 0 1 0 0
0 0 0 0 0 1 0 0 0 0
