blue
pyramid
180
10
11
2 2 2 2 2 2 2 2 2 2
2 1 1 1 1 1 1 1 1 2
2 1 1 3 3 3 1 3 1 2
2 1 1 1 1 1 1 3 1 2
2 1 3 3 1 1 1 1 1 2
2 1 1 1 1 1 1 3 1 2
2 1 3 3 3 3 1 3 1 2
2 1 1 1 1 1 1 1 1 2
2 1 3 1 1 2 2 2 2 2
2 1 3 1 1 2 0 0 0 0
2 2 2 2 2 2 0 0 0 0
7
1 2048 7 1
0 4 6 3
2 15 6 4
0 2 2 5
0 1 5 5
0 4 8 5
2 521 4 7
ETHANAL
4
3
0 0 0 4 0 4 0 0
0 2 2 15 2 521 1 2048
0 0 0 1 0 0 0 0
