blue
ice
240
13
12
3 3 3 3 3 4 3 3 3 3 3 3 3
3 1 1 1 1 4 1 1 1 1 1 1 2
3 1 1 4 1 1 1 5 1 1 4 4 4
3 1 1 1 1 1 1 1 1 1 1 1 3
3 3 4 4 4 4 4 4 4 1 1 1 3
0 0 3 1 1 1 1 1 4 1 1 1 3
0 0 3 1 1 4 1 1 1 1 1 1 3
3 3 3 1 1 1 1 1 1 1 4 1 3
3 1 1 1 4 1 1 1 1 1 4 1 3
3 1 1 1 1 4 4 4 1 1 1 1 3
3 1 1 1 1 1 1 4 1 1 1 1 3
3 3 3 3 3 3 3 4 3 3 3 3 3
10
0 1 3 1
0 8 9 2
0 1 3 3
0 4 7 3
0 4 9 5
2 15 10 5
2 15 6 7
2 1034 8 7
1 256 9 8
0 2 4 9
PROPANON
5
3
0 0 0 4 0 0 0 4 0 0
0 2 2 15 2 1034 2 15 0 8
0 0 0 1 1 256 0 1 0 0
